C  130,  199, 255
NO ./textures/mossy.xpm
SO ./textures/greystone.xpm
EA ./textures/wood.xpm
WE ./textures/bluestone.xpm

F 34,139,34



1111111111111111111111111111111111
1100000000010010010010000000000011
1100000000000000000000000000000011
1100000000000000000000110000000011
1100000000000000000000000000000011
1111000000010000N00000000000011111
1100000000000000000000010000000011
1100000000000000000000000000011111
1100000000000000100000000000000011
1100000000000001110000000000000011
1100000000000011111000000000000011
1111111111111111111111111111111111


